NO ./assets/textures/grass.xpm
SO ./assets/textures/snow.xpm
WE ./assets/textures/red.xpm
EA ./assets/textures/blue.xpm

F 50,100,10
C 100,100,255

11111111111111111111111111111111
10000000000000000000000000000001
10000000000000000000000000000001
10000000000000000000000000000001
10000000000000000000000000000001
10000000000000000000000000000001
1000000000000000000000000000W001
10000000000000000000000000000001
11111111111111111111111111111111
