NO ./textures/N.xpm
SO ./textures/S.xpm
WE ./textures/W.xpm
EA ./textures/E.xpm

F 50,100,10
C 100,100,255

11111111111111111111111111111111
10000000000000000000000000000001
10000000000000000000000000000001
10000000000100000000000000000001
10000000010000100000000000000001
10000S00000000000000000000000001
10000000001000001000000000000001
10000000000000000000000000000001
11111111111111111111111111111111
