NO ./textures/snow.xpm
SO ./textures/blue.xpm
WE ./textures/red.xpm
EA ./textures/grass.xpm

F 255,0,0
C 0,0,255

11111111111111111111111111111111
10000000000000000000000000000001
10000000000000000000000000000001
1000N000000100000000000000000001
10000000010000100000000000000001
10000000000000000000000000000001
10000000001000001000000000000001
10000000000000000000000000000001
11111111111111111111111111111111
