NO ./textures/bricks.xpm
SO ./textures/S.xpm
WE ./textures/grass.xpm
EA ./textures/E.xpm

F 50,100,10
C 100,100,100

11111111111111111111111111111111
10000000000000000000000000000001
10000000000011111111111000000001
10000S00011111111111111111000001
10000000011100000001111111100001
10000000111000111111111111110001
10000000111001111100000000111101
10011111110001111110000011111101
10111111110001111111111111111101
10111001110000111111111111111101
10111001110000011111111111111001
10111001110000000000000000111001
10110001110000000000000000111001
10110001110000000000000000111001
10111001110000000000000000111001
10111101110000000000000000111001
10011111110000011101111101110001
10000000110000011101111001110001
10000000110000011101111001110001
10000000111111111101111111100001
10000000111111111000000000000001
10000000000000000000000000000001
11111111111111111111111111111111