NO ./textures/N.xpm
SO ./textures/S.xpm
WE ./textures/W.xpm
EA ./textures/E.xpm

F 50,100,108
C 255,100,255

1111111111111111111111111111111111111111111
1000000000000000000000N00000000000000000001
1111111111111111111111111111111111111111111
